[layer]
type=Tile Layer 1
data=
0,8,8,8,8,8,8,8,8,8,0,
6,4,1,1,1,1,1,1,1,3,5,
1,1,1,1,1,1,1,1,1,1,0,
0,1,1,1,8,8,8,8,8,8,4,
1,1,1,1,8,5,1,1,1,1,1,
7,1,1,1,8,8,8,8,8,8,8,
1,1,1,1,1,1,1,1,1,1,1,
0,0,0,0,0,0,0,0,0,0,0,
0,0,0,0,0,0,0,0,0,0,0,
0,0,0,0,0,0,0,0,0,0,0,
0,0,0,0,0,0,0,0,0,0,0,
0,0,0,0,0,0,0,0,0,0,0.
[layer]
type=Tile Layer 2
data=
0,0,0,0,0,0,0,0,0,0,0,
20,20,20,20,20,20,20,20,20,20,20,
5,20,20,20,20,20,20,20,20,20,0,
0,2,5,20,0,0,0,0,0,0,20,
2,2,5,20,0,20,20,20,20,20,20,
0,2,5,20,0,0,0,0,0,0,0,
2,2,5,30,30,30,30,30,30,30,30,
0,0,0,0,0,0,0,0,0,0,0,
0,0,0,0,0,0,0,0,0,0,0,
0,0,0,0,0,0,0,0,0,0,0,
0,0,0,0,0,0,0,0,0,0,0,
0,0,0,0,0,0,0,0,0,0,0.
