[layer]
type=Tile Layer 1
data=
0,1,1,1,0,1,1,1,1,1,0,
0,1,0,1,0,1,0,0,0,1,0,
0,1,0,1,0,0,1,21,1,0,0,
0,5,1,6,0,0,1,21,1,0,0,
0,0,1,0,0,4,1,21,1,3,0,
0,0,1,0,0,1,21,21,21,1,0,
0,4,1,3,0,1,1,1,1,1,0,
24,1,1,1,24,5,1,1,1,6,24,
0,0,0,0,0,0,0,0,0,0,0,
0,0,0,0,0,0,0,0,0,0,0,
0,0,0,0,0,0,0,0,0,0,0,
0,0,0,0,0,0,0,0,0,0,0,
0,0,0,0,0,0,0,0,0,0,0.
[layer]
type=Tile Layer 2
data=
0,35,35,35,0,35,35,35,35,35,0,
0,39,0,39,0,39,0,0,0,39,0,
0,35,0,35,0,0,35,0,35,0,0,
0,34,34,34,0,0,34,0,34,0,0,
0,0,33,0,0,33,33,0,33,33,0,
0,0,33,0,0,33,0,0,0,33,0,
0,27,27,27,0,27,27,27,27,27,0,
0,27,27,27,0,27,27,27,27,27,0,
0,0,0,0,0,0,0,0,0,0,0,
0,0,0,0,0,0,0,0,0,0,0,
0,0,0,0,0,0,0,0,0,0,0,
0,0,0,0,0,0,0,0,0,0,0,
0,0,0,0,0,0,0,0,0,0,0.

