[layer]
type=Tile Layer 1
data=
2,0,2,2,2,2,2,2,2,2,2,
1,0,21,0,0,1,1,1,1,1,1,
1,1,1,21,9,1,1,0,0,0,1,
1,1,21,0,0,1,1,1,0,1,1,
1,1,1,1,1,1,1,1,21,1,1,
1,1,0,1,1,1,1,0,0,21,1,
0,0,0,0,30,1,1,0,21,0,1,
0,0,0,0,0,0,0,0,0,0,0,
0,0,0,0,0,0,0,0,0,0,0,
0,0,0,0,0,0,0,0,0,0,0,
0,0,0,0,0,0,0,0,0,0,0.
[layer]
type=Tile Layer 2
data=
24,0,24,24,24,24,24,24,24,24,24,
35,0,0,0,0,35,35,35,35,35,35,
51,51,51,0,30,51,51,0,0,0,51,
33,33,0,0,0,33,33,33,0,33,33,
22,22,22,22,22,22,22,22,0,22,22,
32,32,0,32,32,32,32,0,0,0,32,
0,0,0,0,31,31,31,0,0,0,31,
0,0,0,0,0,0,0,0,0,0,0,
0,0,0,0,0,0,0,0,0,0,0,
0,0,0,0,0,0,0,0,0,0,0,
0,0,0,0,0,0,0,0,0,0,0.

