[layer]
type=Tile Layer 1
data=
8,8,8,8,1,8,1,8,8,8,8,
8,8,8,1,1,8,1,1,8,8,8,
8,8,1,0,0,0,0,0,1,8,8,
8,1,0,8,1,1,1,8,0,1,8,
1,0,8,1,1,1,1,1,8,0,1,
1,8,1,1,0,0,0,1,1,8,1,
0,0,0,0,1,0,1,0,0,0,0,
0,0,0,0,1,1,1,0,0,0,0,
0,0,0,0,0,0,0,0,0,0,0,
0,0,0,0,0,0,0,0,0,0,0,
0,0,0,0,0,0,0,0,0,0,0.
[layer]
type=Tile Layer 2
data=
0,0,0,0,10,0,10,0,0,0,0,
0,0,0,10,10,0,10,10,0,0,0,
0,0,10,0,0,0,0,0,10,0,0,
0,10,0,0,10,10,10,0,0,10,0,
10,0,0,10,10,10,10,10,0,0,10,
10,0,10,10,0,0,0,10,10,0,10,
0,0,0,0,25,0,25,0,0,0,0,
0,0,0,0,25,25,25,0,0,0,0,
0,0,0,0,0,0,0,0,0,0,0,
0,0,0,0,0,0,0,0,0,0,0,
0,0,0,0,0,0,0,0,0,0,0.
