[layer]
type=Tile Layer 1
data=
1,1,1,0,0,1,0,1,0,1,0,
0,1,1,1,3,5,1,6,4,1,1,
1,1,1,1,6,4,1,3,5,1,0,
0,1,1,1,0,1,1,1,0,1,1,
1,1,1,1,0,5,1,6,0,1,0,
0,1,1,1,1,0,1,0,4,1,1,
1,1,1,1,0,0,24,4,1,1,0,
0,29,1,29,1,29,1,29,1,29,1,
1,1,30,1,1,1,1,1,1,1,1,
0,0,0,0,0,0,0,0,0,0,0,
0,0,0,0,0,0,0,0,0,0,0,
0,0,0,0,0,0,0,0,0,0,0,
0,0,0,0,0,0,0,0,0,0,0.
[layer]
type=Tile Layer 2
data=
80,60,27,0,0,60,0,60,0,60,0,
0,60,27,60,37,60,37,60,27,60,80,
80,60,27,60,27,60,27,60,27,60,0,
0,40,27,40,0,40,27,40,0,40,40,
40,27,27,27,0,27,27,27,0,27,0,
0,27,27,27,27,0,27,0,27,27,40,
40,27,27,27,0,0,0,27,27,27,0,
0,40,10,10,10,10,10,10,10,10,10,
10,10,2,10,10,10,10,10,10,10,10,
0,0,0,0,0,0,0,0,0,0,0,
0,0,0,0,0,0,0,0,0,0,0,
0,0,0,0,0,0,0,0,0,0,0,
0,0,0,0,0,0,0,0,0,0,0.

