[layer]
type=Tile Layer 1
data=
0,0,1,1,1,7,1,1,1,0,0,
0,1,1,7,1,0,1,7,1,1,0,
1,1,1,1,7,7,7,1,1,1,1,
0,1,0,1,1,0,1,1,0,1,0,
1,0,0,0,5,0,6,0,0,0,1,
1,1,0,1,0,0,0,1,0,1,1,
1,1,1,1,0,0,0,1,1,1,1,
1,0,0,1,0,7,0,1,0,0,1,
0,0,0,0,0,0,0,0,0,0,0,
0,0,0,0,0,0,0,0,0,0,0,
0,0,0,0,0,0,0,0,0,0,0,
0,0,0,0,0,0,0,0,0,0,0,
0,0,0,0,0,0,0,0,0,0,0,
0,0,0,0,0,0,0,0,0,0,0.
[layer]
type=Tile Layer 2
data=
0,0,20,20,20,0,20,20,20,0,0,
0,40,40,0,40,0,40,0,40,40,0,
30,30,30,30,0,0,0,30,30,30,30,
0,20,0,20,20,0,20,20,0,20,0,
20,0,0,0,20,0,20,20,0,0,20,
20,20,0,30,0,0,0,30,0,20,20,
20,20,20,30,0,0,0,30,20,20,20,
20,0,0,30,0,0,0,30,0,0,20,
0,0,0,0,0,0,0,0,0,0,0,
0,0,0,0,0,0,0,0,0,0,0,
0,0,0,0,0,0,0,0,0,0,0,
0,0,0,0,0,0,0,0,0,0,0,
0,0,0,0,0,0,0,0,0,0,0,
0,0,0,0,0,0,0,0,0,0,0.
