[layer]
type=Tile Layer 1
data=
0,0,0,32,32,32,32,32,0,0,0,
0,0,0,32,33,33,33,32,0,0,0,
0,0,32,33,38,1,38,33,32,0,0,
0,32,33,38,38,38,38,38,33,32,0,
32,33,38,38,38,1,38,38,38,33,32,
33,38,38,38,38,1,38,38,38,38,33,
33,38,38,38,38,1,1,1,38,1,33,
33,38,38,38,38,38,38,38,38,38,33,
32,33,38,38,38,38,38,38,38,33,32,
0,32,33,38,38,38,38,38,33,32,0,
0,0,32,33,38,38,38,33,32,0,0,
0,0,0,32,33,33,33,32,0,0,0,
0,0,0,32,32,32,32,32,0,0,0,
0,0,0,0,0,0,0,0,0,0,0,
0,0,0,0,0,0,0,0,0,0,0,
0,0,0,0,0,0,0,0,0,0,0,
0,0,0,0,0,0,0,0,0,0,0.
[layer]
type=Tile Layer 2
data=
0,0,0,30,30,30,30,30,0,0,0,
0,0,0,60,60,50,20,30,0,0,0,
0,0,60,60,1,70,1,20,30,0,0,
0,60,60,1,1,1,1,1,20,30,0,
60,60,1,1,1,70,1,1,1,20,30,
60,1,1,1,1,70,1,1,1,1,20,
60,1,1,1,1,70,70,70,1,70,20,
60,1,1,1,1,1,1,1,1,1,20,
60,60,1,1,1,1,1,1,1,20,30,
0,60,60,1,1,1,1,1,20,30,0,
0,0,60,60,1,1,1,20,30,0,0,
0,0,0,60,60,50,20,30,0,0,0,
0,0,60,30,30,30,30,30,0,0,0,
0,0,0,0,0,0,0,0,0,0,0,
0,0,0,0,0,0,0,0,0,0,0,
0,0,0,0,0,0,0,0,0,0,0,
0,0,0,0,0,0,0,0,0,0,0.

