[layer]
type=Tile Layer 1
data=
0,0,0,32,32,32,32,32,0,0,0,
0,0,32,38,38,38,38,38,32,0,0,
0,32,38,32,37,37,37,32,38,32,0,
32,38,32,37,37,38,37,37,32,38,32,
32,38,37,38,38,38,38,38,37,38,32,
32,38,37,37,38,38,38,37,37,38,32,
32,38,37,38,38,37,38,38,37,38,32,
32,38,32,38,37,37,37,38,32,38,32,
0,32,38,32,37,37,37,32,38,32,0,
0,0,32,38,38,38,38,38,32,0,0,
0,0,0,32,32,32,32,32,0,0,0,
0,0,0,0,0,0,0,0,0,0,0,
0,0,0,0,0,0,0,0,0,0,0,
0,0,0,0,0,0,0,0,0,0,0,
0,0,0,0,0,0,0,0,0,0,0,
0,0,0,0,0,0,0,0,0,0,0.
[layer]
type=Tile Layer 2
data=
0,0,0,20,20,20,20,20,0,0,0,
0,0,20,1,1,1,1,1,20,0,0,
0,20,1,20,45,45,45,20,1,20,0,
20,1,20,45,45,1,45,45,20,1,20,
20,1,45,1,1,1,1,1,45,1,20,
10,1,45,45,1,1,1,45,45,1,10,
10,1,45,1,1,45,1,1,45,1,10,
10,1,10,1,45,45,45,1,10,1,10,
0,10,1,10,45,45,45,10,1,10,0,
0,0,10,1,1,1,1,1,10,0,0,
0,0,0,10,10,10,10,10,0,0,0,
0,0,0,0,0,0,0,0,0,0,0,
0,0,0,0,0,0,0,0,0,0,0,
0,0,0,0,0,0,0,0,0,0,0,
0,0,0,0,0,0,0,0,0,0,0,
0,0,0,0,0,0,0,0,0,0,0.

