[layer]
type=Tile Layer 1
data=
0,0,0,0,0,0,0,0,1,2,3,
0,0,0,0,0,0,0,0,1,2,6,
0,0,0,0,1,1,3,0,0,0,0,
38,38,38,0,0,1,1,1,0,0,0,
0,38,38,38,0,0,0,0,0,0,0,
0,0,0,0,32,32,32,0,0,0,0,
0,0,0,32,33,33,33,32,0,0,0,
0,0,32,33,33,34,33,33,32,0,0,
0,32,33,33,34,37,34,33,33,32,0,
32,33,33,34,37,36,37,34,33,33,32,
32,33,34,37,36,0,36,37,34,33,32,
32,33,34,37,36,24,36,37,34,33,32,
0,0,0,0,0,0,0,0,0,0,0,
0,0,0,0,0,0,0,0,0,0,0,
0,0,0,0,0,0,0,0,0,0,0,
0,0,0,0,0,0,0,0,0,0,0.
[layer]
type=Tile Layer 2
data=
0,0,0,0,0,0,0,0,50,50,50,
0,0,0,0,0,0,0,0,50,50,50,
0,0,0,0,40,40,40,0,0,0,0,
1,1,1,0,0,40,40,40,0,0,0,
0,1,1,1,0,0,0,0,0,0,0,
0,0,0,0,40,40,40,0,0,0,0,
0,0,0,40,20,20,20,40,0,0,0,
0,0,40,20,20,15,20,20,40,0,0,
0,40,20,20,15,10,15,20,20,40,0,
40,20,20,15,10,10,10,15,20,20,40,
40,20,15,10,10,0,10,10,15,20,40,
40,20,15,10,10,0,10,10,15,20,40,
0,0,0,0,0,0,0,0,0,0,0,
0,0,0,0,0,0,0,0,0,0,0,
0,0,0,0,0,0,0,0,0,0,0,
0,0,0,0,0,0,0,0,0,0,0.

