[layer]
type=Tile Layer 1
data=
1,1,1,1,1,1,1,1,1,1,1,
1,8,8,8,8,8,8,8,8,8,1,
1,8,8,8,1,1,1,8,8,8,1,
1,1,6,0,1,8,1,0,5,1,1,
1,6,4,1,8,0,8,1,3,5,1,
6,4,1,0,1,8,1,0,1,3,5,
0,0,0,0,0,0,0,0,0,0,0,
0,0,0,0,0,0,0,0,0,0,0,
0,0,0,0,0,0,0,0,0,0,0,
0,0,0,0,0,0,0,0,0,0,0,
0,0,0,0,0,0,0,0,0,0,0.
[layer]
type=Tile Layer 2
data=
30,30,30,30,30,50,30,30,30,30,30,
20,0,0,0,0,0,0,0,0,0,20,
20,0,0,0,20,10,20,0,0,0,20,
20,0,50,0,20,0,20,0,50,0,20,
30,50,50,20,0,10,0,20,50,50,30,
50,50,20,0,20,0,20,0,20,50,50,
0,0,0,0,0,0,0,0,0,0,0,
0,0,0,0,0,0,0,0,0,0,0,
0,0,0,0,0,0,0,0,0,0,0,
0,0,0,0,0,0,0,0,0,0,0,
0,0,0,0,0,0,0,0,0,0,0.
