[layer]
type=Tile Layer 1
data=
0,0,0,23,1,23,1,23,0,0,0,
0,0,1,1,1,1,1,1,1,0,0,
0,1,1,0,1,1,1,0,1,1,0,
23,1,0,0,0,1,0,0,0,1,23,
0,1,0,0,1,1,1,0,0,1,0,
23,1,1,1,0,0,0,1,1,1,23,
23,1,1,1,0,0,0,1,1,1,23,
0,1,1,1,0,0,0,1,1,1,0,
0,0,1,0,0,0,0,0,1,0,0,
0,0,0,0,0,0,0,0,0,0,0,
0,0,0,0,0,0,0,0,0,0,0.
[layer]
type=Tile Layer 2
data=
0,0,0,0,32,0,32,0,0,0,0,
0,0,35,35,35,35,35,35,35,0,0,
0,40,40,0,34,30,34,0,40,40,0,
0,40,0,0,0,30,0,0,0,40,0,
0,40,0,0,30,30,30,0,0,40,0,
0,20,20,20,0,0,0,20,20,20,0,
0,20,20,20,0,0,0,20,20,20,0,
0,2,2,2,0,0,0,2,2,2,0,
0,0,2,0,0,0,0,0,2,0,0,
0,0,0,0,0,0,0,0,0,0,0,
0,0,0,0,0,0,0,0,0,0,0.

