[layer]
type=Tile Layer 1
data=
0,0,1,1,1,1,1,1,1,0,0,
0,1,1,1,1,1,1,1,1,1,0,
1,1,1,1,1,1,1,1,1,1,1,
1,1,1,1,1,1,1,1,1,1,1,
1,33,33,33,33,1,33,33,33,33,1,
1,33,26,33,33,1,33,33,26,33,1,
1,33,33,33,38,38,38,33,33,33,1,
1,33,33,33,38,38,38,33,33,33,1,
1,33,33,33,33,38,33,33,33,33,1,
0,33,33,33,33,33,33,33,33,33,0,
0,0,0,0,0,0,0,0,0,0,0,
0,0,0,0,0,0,0,0,0,0,0,
0,0,0,0,0,0,0,0,0,0,0,
0,0,0,0,0,0,0,0,0,0,0.
[layer]
type=Tile Layer 2
data=
0,0,50,50,50,50,50,50,50,0,0,
0,50,50,50,50,50,50,50,50,50,0,
30,30,30,30,30,30,30,30,30,30,30,
30,30,30,30,30,30,30,30,30,30,30,
30,10,10,10,10,10,10,10,10,10,30,
30,10,10,10,10,10,10,10,10,10,30,
30,10,10,10,1,1,1,10,10,10,30,
30,10,10,10,1,1,1,10,10,10,30,
30,10,10,10,10,1,10,10,10,10,30,
0,10,10,10,10,5,10,10,10,10,0,
0,0,0,0,0,0,0,0,0,0,0,
0,0,0,0,0,0,0,0,0,0,0,
0,0,0,0,0,0,0,0,0,0,0,
0,0,0,0,0,0,0,0,0,0,0.

