[layer]
type=Tile Layer 1
data=
0,2,0,0,0,0,0,2,21,0,0,
0,2,2,2,2,2,21,2,2,2,2,
21,1,0,0,0,1,31,0,0,1,1,
1,5,2,1,2,2,2,2,21,5,1,
0,0,0,0,0,7,2,6,21,0,0,
0,1,21,4,1,1,1,1,2,0,2,
0,1,0,0,8,21,5,1,6,0,2,
24,1,1,1,1,1,21,1,0,1,1,
0,5,1,0,0,1,0,0,21,1,0,
0,0,0,0,0,0,0,0,0,0,0,
0,0,0,0,0,0,0,0,0,0,0,
0,0,0,0,0,0,0,0,0,0,0,
0,0,0,0,0,0,0,0,0,0,0.
[layer]
type=Tile Layer 2
data=
0,47,0,0,0,0,0,47,0,0,0,
0,37,37,37,37,37,0,37,37,37,37,
0,40,0,0,0,40,0,0,0,40,40,
27,27,27,27,27,27,27,27,0,27,27,
0,0,0,0,0,0,39,39,0,0,0,
0,34,0,34,34,34,34,34,34,0,34,
0,37,0,0,0,0,37,37,37,0,37,
0,33,33,33,33,33,0,33,0,33,33,
0,36,36,0,0,36,0,0,0,36,0,
0,0,0,0,0,0,0,0,0,0,0,
0,0,0,0,0,0,0,0,0,0,0,
0,0,0,0,0,0,0,0,0,0,0,
0,0,0,0,0,0,0,0,0,0,0.

