[layer]
type=Tile Layer 1
data=
2,2,2,2,2,2,2,2,2,2,2,
1,1,1,0,0,21,1,1,1,1,1,
1,1,1,1,1,29,21,1,1,1,1,
2,0,0,29,2,2,21,0,0,2,2,
0,21,1,1,1,1,1,1,9,1,1,
1,0,1,0,1,1,21,1,1,0,1,
0,0,1,1,1,21,0,1,1,0,0,
21,1,1,1,1,0,1,1,1,1,0,
0,0,0,0,0,0,0,0,0,0,0,
0,0,0,0,0,0,0,0,0,0,0,
0,0,0,0,0,0,0,0,0,0,0,
0,0,0,0,0,0,0,0,0,0,0,
0,0,0,0,0,0,0,0,0,0,0.
[layer]
type=Tile Layer 2
data=
27,27,27,27,27,27,27,27,27,27,27,
41,41,41,0,0,0,41,41,41,41,41,
46,46,46,46,46,10,0,46,46,46,46,
58,0,0,10,58,58,0,0,0,58,58,
0,0,51,51,51,51,51,51,10,51,51,
29,0,29,0,29,29,0,29,29,0,29,
0,0,36,36,36,0,0,36,36,0,0,
0,32,32,32,32,0,32,32,32,32,0,
0,0,0,0,0,0,0,0,0,0,0,
0,0,0,0,0,0,0,0,0,0,0,
0,0,0,0,0,0,0,0,0,0,0,
0,0,0,0,0,0,0,0,0,0,0,
0,0,0,0,0,0,0,0,0,0,0.

