[layer]
type=Tile Layer 1
data=
2,0,2,24,2,21,2,0,0,0,0,
1,1,1,0,1,21,1,1,1,21,1,
2,1,2,24,1,21,1,1,1,21,2,
2,2,2,21,2,21,21,21,21,21,2,
1,1,1,21,1,1,1,1,1,3,5,
2,2,2,7,2,6,0,0,1,0,0,
1,1,1,1,6,0,4,1,1,1,1,
0,0,1,6,0,4,1,0,1,0,1,
1,1,1,0,4,1,1,0,1,0,1,
0,0,0,0,0,0,0,0,0,0,0,
0,0,0,0,0,0,0,0,0,0,0,
0,0,0,0,0,0,0,0,0,0,0,
0,0,0,0,0,0,0,0,0,0,0.
[layer]
type=Tile Layer 2
data=
70,0,70,0,70,0,70,0,0,0,0,
41,20,41,0,39,0,41,41,41,0,41,
40,20,40,0,39,0,41,41,41,0,40,
39,39,39,0,39,0,0,0,0,0,39,
27,27,27,0,27,27,27,27,27,27,27,
57,57,57,0,57,36,0,0,10,0,0,
26,26,26,50,26,0,26,26,26,26,26,
0,0,36,36,0,36,36,0,36,0,36,
36,36,36,0,50,36,36,0,36,0,36,
0,0,0,0,0,0,0,0,0,0,0,
0,0,0,0,0,0,0,0,0,0,0,
0,0,0,0,0,0,0,0,0,0,0,
0,0,0,0,0,0,0,0,0,0,0.

