[layer]
type=Tile Layer 1
data=
47,47,40,0,0,0,0,0,0,0,0,
54,54,61,0,47,47,40,0,0,0,0,
0,0,0,0,54,54,61,47,47,40,0,
0,0,0,0,0,0,0,54,54,61,0,
0,0,0,58,37,44,0,0,0,0,0,
0,44,0,0,58,37,44,0,0,0,0,
7,35,35,35,35,35,35,35,35,42,0,
7,35,35,35,35,35,35,35,35,63,0,
0,65,0,0,51,37,65,0,0,0,0,
0,0,0,51,37,65,0,0,0,0,0,
0,0,0,0,0,0,0,0,0,0,0,
0,0,0,0,0,0,0,0,0,0,0,
0,0,0,0,0,0,0,0,0,0,0,
0,0,0,0,0,0,0,0,0,0,0.
[layer]
type=Tile Layer 2
data=
40,40,40,0,0,0,0,0,0,0,0,
40,40,40,0,40,40,40,0,0,0,0,
0,0,0,0,40,40,40,40,40,40,0,
0,0,0,0,0,0,0,40,40,40,0,
0,0,0,30,30,30,0,0,0,0,0,
0,30,0,0,30,30,30,0,0,0,0,
0,50,50,50,50,50,50,50,50,50,0,
0,50,50,50,50,50,50,50,50,50,0,
0,30,0,0,30,30,30,0,0,0,0,
0,0,0,30,30,30,0,0,0,0,0,
0,0,0,0,0,0,0,0,0,0,0,
0,0,0,0,0,0,0,0,0,0,0,
0,0,0,0,0,0,0,0,0,0,0,
0,0,0,0,0,0,0,0,0,0,0.

