[layer]
type=Tile Layer 1
data=
29,1,1,1,6,29,5,1,1,1,29,
1,29,1,6,4,1,3,5,1,29,1,
6,0,1,3,0,0,0,4,1,0,5,
0,1,1,1,3,0,4,1,1,1,0,
0,1,1,1,1,0,1,1,1,1,0,
0,1,29,1,1,0,1,1,29,1,0,
0,1,1,29,1,1,1,29,1,1,0,
0,0,1,1,29,1,29,1,1,0,0,
0,0,0,0,0,29,0,0,0,0,0,
0,0,0,0,0,0,0,0,0,0,0,
0,0,0,0,0,0,0,0,0,0,0.
[layer]
type=Tile Layer 2
data=
5,30,30,30,30,5,30,30,30,30,5,
30,5,30,35,30,30,30,35,30,5,30,
30,0,50,50,0,0,0,50,50,0,30,
0,38,30,50,38,0,38,50,30,38,0,
0,30,30,30,30,0,30,30,30,30,0,
0,60,40,40,30,0,30,40,40,60,0,
0,60,60,10,60,60,60,10,60,60,0,
0,0,60,60,10,60,10,60,60,0,0,
0,0,0,0,0,5,0,0,0,0,0,
0,0,0,0,0,0,0,0,0,0,0,
0,0,0,0,0,0,0,0,0,0,0.

