[layer]
type=Tile Layer 1
data=
0,1,0,1,0,1,3,5,0,1,0,
1,0,1,0,1,0,1,3,5,0,1,
7,1,1,1,1,1,1,1,7,1,7,
1,1,1,1,1,1,6,7,4,1,1,
1,1,1,0,1,6,7,4,1,0,1,
1,1,0,1,6,7,4,1,0,1,1,
1,0,1,6,7,4,1,0,1,1,1,
1,1,0,0,1,1,0,0,1,1,0,
0,0,2,2,0,0,0,0,0,0,0,
0,0,0,0,0,0,0,0,0,0,0,
0,0,0,0,0,0,0,0,0,0,0,
0,0,0,0,0,0,0,0,0,0,0,
0,0,0,0,0,0,0,0,0,0,0.
[layer]
type=Tile Layer 2
data=
30,30,30,30,30,30,30,30,30,30,30,
30,30,30,30,30,30,30,30,30,30,30,
0,30,30,30,30,30,30,30,0,30,0,
30,30,30,10,30,30,30,0,30,10,30,
30,30,30,0,30,30,0,30,30,0,30,
30,30,0,30,30,0,30,30,0,30,30,
30,0,30,30,0,30,30,0,30,30,30,
10,10,0,0,10,10,0,0,10,10,0,
0,0,5,2,0,0,0,0,0,0,0,
0,0,0,0,0,0,0,0,0,0,0,
0,0,0,0,0,0,0,0,0,0,0,
0,0,0,0,0,0,0,0,0,0,0,
0,0,0,0,0,0,0,0,0,0,0.
