[layer]
type=Tile Layer 1
data=
0,1,1,1,0,0,0,1,1,1,0,
0,1,1,1,0,0,0,1,1,1,0,
0,1,1,1,1,1,1,1,1,0,0,
0,0,1,38,38,38,38,38,1,0,0,
0,0,1,38,38,38,38,38,1,0,0,
0,0,1,38,1,38,1,38,1,0,0,
0,0,38,38,38,38,38,38,38,0,0,
0,0,0,0,1,1,1,0,0,0,0,
0,0,0,0,32,32,32,0,0,0,0,
0,0,0,0,32,32,32,1,0,0,0,
0,0,0,0,33,0,33,0,0,0,0,
0,0,0,0,0,0,0,0,0,0,0,
0,0,0,0,0,0,0,0,0,0,0,
0,0,0,0,0,0,0,0,0,0,0,
0,0,0,0,0,0,0,0,0,0,0,
0,0,0,0,0,0,0,0,0,0,0.
[layer]
type=Tile Layer 2
data=
0,100,100,110,0,0,0,110,100,100,0,
0,100,100,110,0,0,0,110,100,100,0,
0,100,100,110,110,110,110,110,100,0,0,
0,0,100,1,1,1,1,1,100,0,0,
0,0,100,1,1,1,1,1,100,0,0,
0,0,100,1,150,1,150,1,100,0,0,
0,0,1,1,1,1,1,1,1,0,0,
0,0,0,0,60,60,60,0,0,0,0,
0,0,0,0,70,70,70,0,0,0,0,
0,0,0,0,70,70,70,60,0,0,0,
0,0,0,0,70,0,70,0,0,0,0,
0,0,0,0,0,0,0,0,0,0,0,
0,0,0,0,0,0,0,0,0,0,0,
0,0,0,0,0,0,0,0,0,0,0,
0,0,0,0,0,0,0,0,0,0,0,
0,0,0,0,0,0,0,0,0,0,0.
