[layer]
type=Tile Layer 1
data=
6,5,1,1,6,5,1,1,6,5,1,
1,1,6,5,1,1,6,5,1,1,6,
6,5,1,1,6,5,1,1,6,5,1,
1,1,1,1,1,1,1,1,1,1,1,
6,5,6,5,6,5,6,5,6,5,6,
4,3,4,3,4,3,4,3,4,3,4,
5,6,5,6,5,6,5,6,5,6,5,
0,1,0,1,0,1,0,1,0,1,0,
1,0,4,0,3,0,4,0,3,0,1,
0,0,0,0,0,0,0,0,0,0,0,
0,0,0,0,0,0,0,0,0,0,0,
0,0,0,0,0,0,0,0,0,0,0,
0,0,0,0,0,0,0,0,0,0,0.
[layer]
type=Tile Layer 2
data=
5,30,30,1,30,30,1,30,30,30,5,
5,30,1,30,5,5,30,1,30,30,5,
5,1,25,25,5,5,25,25,1,30,5,
25,25,25,25,5,5,25,25,25,25,25,
20,20,20,20,5,5,20,20,20,20,20,
10,10,5,5,5,5,5,5,10,10,10,
10,10,5,5,5,5,5,5,10,10,10,
0,2,0,2,0,2,0,2,0,2,0,
2,0,2,0,2,0,2,0,2,0,2,
0,0,0,0,0,0,0,0,0,0,0,
0,0,0,0,0,0,0,0,0,0,0,
0,0,0,0,0,0,0,0,0,0,0,
0,0,0,0,0,0,0,0,0,0,0.

