[layer]
type=Tile Layer 1
data=
0,33,0,0,0,32,0,0,0,37,0,
33,33,33,0,32,32,32,0,37,37,37,
38,38,38,0,32,32,1,0,37,37,37,
38,38,38,0,1,32,32,0,37,37,37,
34,34,34,0,32,1,32,0,37,37,37,
34,34,34,0,35,35,35,0,37,37,37,
0,33,0,0,0,33,0,0,0,33,0,
0,0,0,0,0,0,0,0,0,0,0,
37,37,37,0,37,37,37,0,37,37,37,
37,0,37,0,37,0,37,0,37,0,37,
37,37,37,0,37,0,37,0,37,37,37,
37,0,0,0,37,0,37,0,37,0,0,
37,0,0,0,37,37,37,0,37,0,0,
0,0,0,0,0,0,0,0,0,0,0,
21,21,21,21,21,21,21,21,21,21,21,
0,0,0,0,0,0,0,0,0,0,0,
0,0,0,0,0,0,0,0,0,0,0,
0,0,0,0,0,0,0,0,0,0,0.
[layer]
type=Tile Layer 2
data=
0,70,0,0,0,80,0,0,0,100,0,
70,70,70,0,80,80,80,0,100,100,100,
1,1,1,0,80,80,100,0,100,100,100,
1,1,1,0,100,80,80,0,100,100,100,
70,70,70,0,80,100,80,0,100,100,100,
70,70,70,0,80,80,80,0,100,100,100,
0,100,0,0,0,100,0,0,0,100,0,
0,0,0,0,0,0,0,0,0,0,0,
60,70,80,0,70,70,70,0,60,70,80,
50,0,70,0,70,0,70,0,50,0,70,
10,50,60,0,70,0,70,0,10,50,60,
5,0,0,0,70,0,70,0,5,0,0,
1,0,0,0,70,70,70,0,1,0,0,
0,0,0,0,0,0,0,0,0,0,0,
0,0,0,0,0,0,0,0,0,0,0,
0,0,0,0,0,0,0,0,0,0,0,
0,0,0,0,0,0,0,0,0,0,0,
0,0,0,0,0,0,0,0,0,0,0.

