[layer]
type=Tile Layer 1
data=
37,0,37,0,0,0,0,0,0,0,0,
37,0,37,0,0,36,36,36,0,50,0,
37,37,37,0,36,36,36,36,36,36,0,
0,37,7,33,33,33,33,33,33,57,0,
0,37,33,1,33,33,33,1,33,33,0,
0,33,33,1,32,32,32,1,33,33,33,
0,33,33,33,1,32,1,33,33,33,33,
0,0,33,33,33,33,33,33,33,33,0,
0,0,33,33,33,31,33,33,33,33,0,
0,0,0,33,33,33,33,33,33,33,0,
0,0,0,0,33,33,33,33,33,0,0,
0,23,0,0,0,1,0,1,0,0,0,
0,23,23,0,4,1,4,1,0,23,23,
0,0,0,0,0,0,0,0,0,0,0,
0,0,0,0,0,0,0,0,0,0,0,
0,0,0,0,0,0,0,0,0,0,0,
0,0,0,0,0,0,0,0,0,0,0.
[layer]
type=Tile Layer 2
data=
150,0,150,0,0,0,0,0,0,0,0,
150,0,150,0,0,120,120,120,0,120,0,
150,150,150,0,120,120,120,120,120,120,0,
0,150,0,100,100,100,100,100,100,120,0,
0,150,100,100,100,100,100,100,100,100,0,
0,30,100,100,100,100,100,100,100,100,30,
0,30,80,80,100,100,100,80,80,60,30,
0,0,30,80,80,80,80,80,80,30,0,
0,0,30,30,40,0,40,30,30,30,0,
0,0,0,30,40,40,40,30,30,30,0,
0,0,0,0,30,30,30,30,30,0,0,
0,0,0,0,0,20,0,20,0,0,0,
0,0,0,0,20,20,20,20,0,0,0,
0,0,0,0,0,0,0,0,0,0,0,
0,0,0,0,0,0,0,0,0,0,0,
0,0,0,0,0,0,0,0,0,0,0,
0,0,0,0,0,0,0,0,0,0,0.

