[layer]
type=Tile Layer 1
data=
0,0,2,2,0,0,0,2,2,0,0,
0,2,0,0,2,2,2,0,0,2,0,
0,2,1,1,0,2,0,1,1,2,0,
21,1,0,4,1,1,1,3,0,1,21,
21,1,24,5,1,1,1,6,24,1,21,
0,1,0,0,21,1,21,0,0,1,0,
0,1,1,1,21,1,21,1,1,1,0,
0,1,0,0,1,1,1,0,0,1,0,
0,0,0,0,0,0,0,0,0,0,0,
0,0,0,0,0,0,0,0,0,0,0,
0,0,0,0,0,0,0,0,0,0,0,
0,0,0,0,0,0,0,0,0,0,0,
0,0,0,0,0,0,0,0,0,0,0.
[layer]
type=Tile Layer 2
data=
0,0,46,46,0,0,0,46,46,0,0,
0,46,0,0,46,46,46,0,0,46,0,
0,61,61,61,0,61,0,61,61,61,0,
0,41,0,41,41,41,41,41,0,41,0,
0,58,0,58,58,58,58,58,0,58,0,
0,38,0,0,0,38,0,0,0,38,0,
0,36,36,36,0,36,0,36,36,36,0,
0,36,0,0,36,36,36,0,0,36,0,
0,0,0,0,0,0,0,0,0,0,0,
0,0,0,0,0,0,0,0,0,0,0,
0,0,0,0,0,0,0,0,0,0,0,
0,0,0,0,0,0,0,0,0,0,0,
0,0,0,0,0,0,0,0,0,0,0.

